|cardoso	k A: . d @u 1 . s @u
|chelsea	tS E 1 l . s i:
|chippa	tS @ 1 . p a
|daniel	d { 1 . n i@ l
|dante	d a 1 n . t @i
|dillon	d @ 1 . l @ n
|dischem	d @ 1 s . k E m
|duminy	d u 1 . m @ . n i
|ee	i: 1
|etc	E t . s E 1 . t @ . r\ a
|gaum	g au 1 m
|mrs	m @ 1 . s @ z
|odi	@u 1 . d i
|pascal	p { 1 . s k @ l
|rancho	r\ A: 1 n . tS @u
|s	s
|st	s @ 1 n t
|unwin	a 1 n . w @ n
|wilderness	w @ 1 l . d @ . n @ s
|william	w i 1 . l i: . @ m
|williams	w i 1 . l i: . @ m z
|yorkshire	j O: 1 k . S 3:
